################################################
#                                              #
#               #       #          #           #
#               #       #          #           #
#               #       #          #           #
#               #       #          #           #
#               #       #          #           #
#          #    #       #          #           #
#          #    #       #          #           #
#          #    #       #          #           #
#          #    #       #          #           #
#          #    #       #          #           #
#          #    #       #          #           #
#       D  #  D #   D   #       D  #           #
#          #    #       #          #           #
#          #    #       #          #           #
#          #    #       #          #           #
#          #    #       #          #           #
#          #    #       #          #           #
#          #    #       #          #           #
#          #    #       #          #           #
#          #    #       #          #           #
#          #    #       #          #           #
#                                              #
################################################