################################################
#                                              #
#               #       #          #           #
#               #       #          #           #
#               #       #          #           #
#               #       #          #           #
#               #       #          #           #
#          #    #       #          #           #
#          #    #       #          #           #
#          #    #       #          #           #
#          #    #       #          #           #
#          #    #       #          #           #
#     D    #    #       #          #           #
#          #    #       #          #           #
#          #    #       #          #           #
#          #    #       #          #           #
#          #    #       #          #           #
#          #    #       #          #           #
#          #    #       #          #           #
#          #    #       #          #           #
#          #    #       #          #           #
#          #    #       #          #           #
#          #    #       #          #           #
#                                              #
################################################